11111111111111111111111111111111111111111111111111
10000000000000000000000000000000C00000000000000001
10000P000000C0000000000000000000000000000000000001
100000000000000000000000000000000000000000C0000001
10000001000000000100110010000000001001100000000001
10000000100000001001001001000000010010010000000001
10000000010000010010000100100000100100001000000001
10000000001000100010000100010001000100001000000001
10000000000101000001001000001010000010010000000001
10000000000010000000110000000100000001100000000001
10000000000000000000000000000000000000000000000001
10000000111111110010000100111111110010000100000001
10000000000010000010000100000100000010000100000001
10000000000010000010000100000100000010000100000001
10000000000010000010000100000100000010000100000001
10000000100010000010000101000100000010000100000001
10000000111110000001111001111100000001111000000001
100000000000000000000000000000000000000000000C0001
100000000000000C0000000000000000000000E00000000001
10000000000000000000000000000000000000000000000001
11111111111111111111111111111111111111111111111111
