1111111111111111111111
1000C000000C0000000101
1000000011000000000101
100E000000000010000111
100000C00000000000C1P1
1111111111111111111111
