111111111111111111111111
1C00000010000000000001C1
1000P00000000000000C0101
10C000000000010000000001
101000000C000000000C0001
100000000001000000000001
1000C000000000000000E001
111111111111111111111111
