1111111
10C0001
1000001
10000P1
100C001
10000E1
1111111
